----p-----
-        t
-        -
-        -
-    ---/-
-        -
-        l
-        -
------/---

Salad

1 3
1 4
1 5
2 4
